{
    "1": 0,
    "2": 2000,
    "3": 2000,
    "4": 2000,
    "5": 2000,
    "6": 2001,
    "7": 2001,
    "8": 2001,
    "9": 2001
}